1111111
1P00001
1000001
1011111
1G0M0M1
1111101
1EC0C01
1111111