1111111
10EC1G1
1MMMMM1
1P00001
1111111