111111111
1P00CCCC1
101111111
10M0MGME1
111111111