11111111111
1P00C01E1C1
11111111111