1111111
1CEPMG1
1C00MM1
1C00MM1
1111111