11111111111111111111111
10000000000000000000001
10011001100011111111001
10011CC1100ECCCCCC11001
100111111110111111110G1
100CCCC1100P11CCCCCC001
100CCCC1100011111111001
10000000000000000000001
11111111111111111111111