11111111111111111111111111111
10000000000000000000000000001
10000110011000001111111100G01
1000011CC11000E0CCCCCC1100G01
10000111111110001111111100G01
10000CCCC11000P011CCCCCC00G01
10000CCCC11000001111111100G01
10000000000000000000000000001
11111111111111111111111111111