11111111111111111111111
10000000000000000000001
10011001100011111111001
10011CC1100E0C0C0C11001
100111111110111111110G1
10000CC1100P11C0C0C0001
10000CC1100011111111001
10000000000000000000001
11111111111111111111111