111111111111111111111111111111111
100000000000000000000000000000001
100000011001100000111111110000G01
100000011CC11000E0CCCCCC110000G01
100000011111111000111111110000G01
1000000CCCC11000P011CCCCCC0000G01
1000000CCCC1100000111111110000G01
100000000000000000000000000000001
111111111111111111111111111111111