111111111
1P00E00M1
1C1C1C0C1
111111111