111111111
1C1C1C1C1
1P0C0C0E1
111111111