11111111111
1E00CCCCCP1
11111111111