1111111111111111111111111111111111
1E0000000000000C00000C000000000101
1110010100100001101001100000000101
11111100101010000010011000M0000101
100001110C00C00100000010000001GPC1
1111111111111111111111111111111111