1111111111111111111111111111111111
1E1000000000000C00000C000000000101
1110010100100001101001100000000101
111111001010101P001001100000000101
100001110C00C0010000001000000101C1
1111111111111111111111111111111111