1111111111
1MMMMCPEG1
1111111111