1111111111
1MM1MCPEG1
1111111111