11111111111111111
100M0C00C00C0M001
1000M0M0C000M0001
1P0G0M00000M000E1
10000MM0C0M000001
100CM00MCM000C001
11111111111111111