11111
11C11
1CPC1
11C11
11E11
11111