11111111111111
100000M000M0G1
1P0C0C0C0C00E1
1000M000M00001
11111111111111