111111111
1P0G0MCE1
100011111
111111111