111111111
100000001
100011111
1P0G0MCE1
100011111
100000001
111111111