1111111
1C0P0C1
1C000C1
1C000C1
1C000C1
1CCECC1
1111111